Mamma mia! The world's most famous pizza chef, Pesto di Beppo, is coming to your restaurant in an hour and you still haven't made the pizza you promised him. You stand in the kitchen wondering what to do. North of the kitchen is a store filled with all kinds of gourmet foods and fancy supplies. West of the kitchen is your bedroom where you used to sleep every night after the restaurant closed. To your east is the dining room where you take special guests to enjoy your latest creations. Behind you is the restaurant, which is closed for the weekend.

Pizza Maker
An Interactive Fiction by Brennan
Release 1 / Serial number 141007 / Inform 7 build 6L38 (I6/v6.33 lib 6/12N) SD

Kitchen
Despite being one of the best pizza makers in the country, your kitchen is quite humble. You see a countertop dusted with flour, a box filled with spices, and your fridge.

I beg your pardon?

>open box
Oh no! You completely forgot that yesterday was National Pizza Day! No wonder the kitchen is so empty! Now, the only jar left in the box is filled with baking soda. What kind of pizza can you make with just baking soda!?

>x baking soda
The jar is almost filled to the top with baking soda. The only reason you have baking soda in the first place is because the new guy bought baking soda instead of baking powder.

>open baking soda
It isn't something you can open.

* * *

>ask man about dog
You can't see any such thing.

>n
Store
A middle-aged man runs the store just north of the Kitchen. Since there are fewer customers today, the only things in the room besides you and the man is a table where the man has placed what he is selling and a little oven in the back.

>ask many about dog
You can't see any such thing.

>ask man about doug
He doesn't care about that. The only thing he wants to talk about is his daughter. It's kind of weird, really.

There is no reply.

>ask man about dog
aloha

* * *

>x the player
You are the great-grandson of Raffaele Esposito, the man who many say created pizza.

>x player
You are the great-grandson of Raffaele Esposito, the man who many say created pizza.

>x me
You are the great-grandson of Raffaele Esposito, the man who many say created pizza.

>x myself
You are the great-grandson of Raffaele Esposito, the man who many say created pizza.

>x mirror
You can't see any such thing.

>x shiny surface
You can't see any such thing.

* * *

>x player
You are the great-grandson of Raffaele Esposito, the man who many say created pizza.

>x reflection
You are the great-grandson of Raffaele Esposito, the man who many say created pizza.

>x mirror
You are the great-grandson of Raffaele Esposito, the man who many say created pizza.

>x shiny surface
You can't see any such thing.

* * *

>kill woman
You can't see any such thing.

>kill man
You can't see any such thing.

>kill middle-aged mna
You can't see any such thing.

>kill middle-aged man
You can't see any such thing.

>n
Store
A middle-aged man runs the store just north of the Kitchen. Since there are fewer customers today, the only things in the room besides you and the man is a table where the man has placed what he is selling and a little oven in the back.

>kill man
Before you can even raise a finger, the man pulls out a spatula. With a swift hand he smacks it into your face. "Don't touch me, you moldy sack of clams!" he shouts.

>kill middle
You can't see any such thing.

* * *

>x countertop
The countertop is made of shiny black marble. A large box of spices is placed on the countertop.

>x box
The box is about the size of an old desktop computer. It's made of cardboard and smells slightly of oregano. The box is closed shut to keep the spices inside fresh.

>open box
Oh no! You forgot that yesterday you made fifty pizzas and now the only jar left in the box is filled with baking soda. What kind of pizza can you make with just baking soda!?

* * *

>take all
There are none at all available!

* * *

>x player
You can't see any such thing.

>examine the player
You can't see any such thing.

>examining the player
That's not a verb I recognise.

* * *

>open fridge
You open the fridge to find nothing of interest. Besides a bottle of "Volcano Hot Sauce" and a bottle of apple juice, everything else had already been used up the day before.

>x juice
A clear bottle holds apple juice inside. The liquid is a light yellow and smells like apples.

* * *

>e
Dining Room
The table is set and ready for Pesto di Beppo's arrival. Out of the corner of your eye you spot an embarrassing magazine laying on the table.

>take magazine
Taken.

>look
Dining Room
The table is set and ready for Pesto di Beppo's arrival.

>x table
The table is made of beautiful oak wood. The utensils are perfectly set. You're scared to even breathe in this room at the risk of messing up the arrangement of the utensils.

* * *

>inspect box
That's not a verb I recognise.

>x box
The box is about the size of an old desktop computer. It's made of cardboard and smells slightly of oregano. The box is closed shut to keep the spices inside fresh.

>open box
Oh no! You completely forgot that yesterday was National Pizza Day! No wonder the kitchen is so empty! Now, the only jar left in the box is filled with baking soda. What kind of pizza can you make with just baking soda!?

>take jars
What kind of pizza are you planning to make with empty jars?

>take other jars
What kind of pizza are you planning to make with empty jars?

>take baking soda
Taken.

>x baking soda
The jar is filled to the top with baking soda. The only reason you have baking soda in the first place is because the new guy bought baking soda instead of baking powder.

>open jar
You shouldn't open the baking soda. Maybe if you keep the container closed you can return it to wherever the new guy bought it from.

>x fridge
The fridge is black and tall. It gives off a faint hum.

>open fridge
You open the fridge to find nothing of interest. Besides a bottle of "Volcano Hot Sauce" and vinegar, everything else had already been used up the day before.

>take frdige
You can't see any such thing.

>take fridge
That's hardly portable.

>take hot sauce
The only thing you'd be making with that hot sauce is a bad decision.

>take Volcano sauce
The only thing you'd be making with that hot sauce is a bad decision.

>i
You are carrying:
  a jar of baking soda

>take vinegar
You'd better keep the vinegar refridgerated. Who knows why it's in the fridge anyway?

* * *

>x fridge
The fridge is black and tall. It gives off a faint hum.

* * *

>open fridge
You open the fridge to find nothing of interest. Besides a bottle of "Volcano Hot Sauce" and vinegar, everything else had already been used up the day before.

>take fridge
That's hardly portable.

>open box
Oh no! You completely forgot that yesterday was National Pizza Day! No wonder the kitchen is so empty! Now, the only jar left in the box is filled with baking soda. What kind of pizza can you make with just baking soda!?

>i baking soda
I only understood you as far as wanting to take inventory.

>look at baking soda
The jar is filled to the top with baking soda. The only reason you have baking soda in the first place is because the new guy bought baking soda instead of baking powder.

>take baking soda
Taken.

>w
Bedroom
The bedroom is empty. You decided last week that it was time to stop sleeping next to the kitchen and get a real apartment. On the wall hangs a poster that says "BE GENEROUS. HELP SOMEBODY OUT. GIVE WHAT YOU HAVE TO OTHERS."

>x poster
The poster, written in large Helvetica font, reads "BE GENEROUS. HELP SOMEBODY OUT. GIVE WHAT YOU HAVE TO OTHERS."

>take poster
Just leave it. You can't have everything. Did you even read the poster?

>e
Kitchen
Despite being one of the best pizza makers in the country, your kitchen is quite humble. You see a countertop dusted with flour, a box filled with spices, and your fridge.

>e
Dining Room
The table is set and ready for Pesto di Beppo's arrival. Out of the corner of your eye you spot an embarrasing magazine laying on the table.

>take table
That's hardly portable.

>x table
The table is made of beautiful oak wood. The utensils are perfectly set. You're scared to even breathe in this room at the risk of messing up the arrangement of the utensils. On the corner of the table is an embarrasing magazine.

>take utensils
You wouldn't dare to touch the utensils. You'll surely mess up how nicely they were set.

>take magazine
Taken.

>w
Kitchen
Despite being one of the best pizza makers in the country, your kitchen is quite humble. You see a countertop dusted with flour, a box filled with spices, and your fridge.

>i
You are carrying:
  an embarrasing magazine
  a jar of baking soda

>n
Store
A middle-aged man runs the store just north of the Kitchen. Since there are fewer customers today, the only things in the room besides you and the man is a table where the man has placed what he is selling and a little oven in the back.

>x man
He's the kind of man that looks like a Father. He's wearing a shirt that says "Ask Me About My Daughter"

>ask man about daughter
The man seems distracted... He looks at you. "Can I tell you something?" he asks. Before you can answer he starts talking. "My daughter has this big science project due next week... it's like a big deal for her. More than anything I just want her to be happy. I really want to help her make a baking soda and vinegar volcano but I can't find baking soda anywhere. I'd give the person who could get me baking soda anything they ever wanted.

>give man baking soda
The man smiles at you. "Thank you so much", he says. "This will be so helpful for my daughter's science project... Here, let me give you something"

The man turns and walks to the little oven in the back of the store. He opens it and pulls out a hot, delcious-looking pizza.

"Here you go," he says. "Enjoy!"

>give man baking soda
The man smiles at you. "Thank you so much", he says. "This will be so helpful for my daughter's science project... Here, let me give you something"

The man turns and walks to the little oven in the back of the store. He opens it and pulls out a hot, delcious-looking pizza.

"Here you go," he says. "Enjoy!"

* * *

>n
Store
A middle-aged man runs the store just north of the Kitchen. Since there are fewer customers today, the only thing in the room besides you and the man is a little oven in the back.

>talk about daughter
I didn't understand that sentence.

>talk to man
He really isn't a big fan of talking. He loves answering questions though.

>talk about daughter
I didn't understand that sentence.

>ask about daughter
You can't see any such thing.

>ask man about daughter
The man seems distracted... He looks at you. "Can I tell you something?" he asks. Before you can answer he starts talking. "My daughter has this big science project due next week... it's like a big deal for her. More than anything I just want her to be happy. I really want to help her make a baking soda and vinegar volcano but I can't find baking soda anywhere. I'd give the person who could get me baking soda anything they ever wanted.

>give baking soda to man
You can't see any such thing.

* * *

>n
Store
A middle-aged man runs the store just north of the Kitchen. Since there are fewer customers today, the only thing in the room besides you and the man is a little oven in the back.

>give man vinegar
You can't see any such thing.

* * *

>open box
Oh no! You completely forgot that yesterday was National Pizza Day! No wonder the kitchen is so empty! Now, the only jar left in the box is filled with baking soda. What kind of pizza can you make with just baking soda!?

>take soda
Taken.

>n
Store
A middle-aged man runs the store just north of the Kitchen. Since there are fewer customers today, the only things in the room besides you and the man is a table where the man has placed what he is selling and a little oven in the back.

>give man jar
The man smiles at you. "Thank you so much", he says. "This will be so helpful for my daughter's science project... Here, let me give you something"

The man turns and walks to the little oven in the back of the store. He opens it and pulls out a hot, delcious-looking pizza.

"Here you go," he says. "Enjoy!"

>wait
Time passes.

* * *

>n
Store
A middle-aged man runs the store just north of the Kitchen. Since there are fewer customers today, the only things in the room besides you and the man is a table where the man has placed what he is selling and a little oven in the back.

>give soda to man
The man smiles at you. "Thank you so much", he says. "This will be so helpful for my daughter's science project... Here, let me give you something"

The man turns and walks to the little oven in the back of the store. He opens it and pulls out a hot, delcious-looking pizza.

"Here you go," he says. "Enjoy!"

    *** You did it! You have the perfect pizza to give to Pesto di Beppo. A few minutes later he arrives and begins eating right away. Despite pizza being the only thing served, he didn't complain, because pizza is the only thing he ate anyway. After complimenting the amount of sauce in the pizza, Pesto hands you a check.

"This is for you", he says. "Use it to make more pizza." Pesto di Beppo stands up out of his seat and heads to the door before turning around. He looks at you fondly and says, "Mama mia, my brother." ***

Would you like to RESTART, RESTORE a saved game, QUIT or UNDO the last command?

* * *

>open box
Oh no! You completely forgot that yesterday was National Pizza Day! No wonder the kitchen is so empty! Now, the only jar left in the box is filled with baking soda. What kind of pizza can you make with just baking soda!?

>take jar
Taken.

>n
Store
A middle-aged man runs the store just north of the Kitchen. Since there are fewer customers today, the only things in the room besides you and the man is a table where the man has placed what he is selling and a little oven in the back.

>give jar to man
The man smiles at you. "Thank you so much", he says. "This will be so helpful for my daughter's science project... Here, let me give you something"

The man turns and walks to the little oven in the back of the store. He opens it and pulls out a hot, delcious-looking pizza.

"Here you go," he says. "Enjoy!"

* * *

>open box
Oh no! You completely forgot that yesterday was National Pizza Day! No wonder the kitchen is so empty! Now, the only jar left in the box is filled with baking soda. What kind of pizza can you make with just baking soda!?

>take baking soda
Taken.

>n
Store
A middle-aged man runs the store just north of the Kitchen. Since there are fewer customers today, the only things in the room besides you and the man is a table where the man has placed what he is selling and a little oven in the back.

>give baking soda to man
The man smiles at you. "Thank you so much", he says. "This will be so helpful for my daughter's science project... Here, let me give you something"

The man turns and walks to the little oven in the back of the store. He opens it and pulls out a hot, delciious-looking pizza.

"Here you go," he says. "Enjoy!"

>x pizza
Wow, pizza!

>open oven
It isn't something you can open.

>i
You are carrying:
  a jar of baking soda

>take pizza
Taken.

* * *

>n
Store
A middle-aged man runs the store just north of the Kitchen. Since there are fewer customers today, the only things in the room besides you and the man is a table where the man has placed what he is selling and a little oven in the back.

>give man soda
The man smiles at you. "Thank you so much", he says. "This will be so helpful for my daughter's science project... Here, let me give you something"

The man turns and walks to the little oven in the back of the store. He opens it and pulls out a hot, delcious-looking pizza.

"Here you go," he says. "Enjoy!"

* * *

>take baking soda
Taken.

>north
Store
A middle-aged man runs the store just north of the Kitchen. Since there are fewer customers today, the only things in the room besides you and the man is a table where the man has placed what he is selling and a little oven in the back.

* * *

>open box
Oh no! You completely forgot that yesterday was National Pizza Day! No wonder the kitchen is so empty! Now, the only jar left in the box is filled with baking soda. What kind of pizza can you make with just baking soda!?

>x baking soda
The jar is filled to the top with baking soda. The only reason you have baking soda in the first place is because the new guy bought baking soda instead of baking powder.

* * *

>open jar
You shouldn't open the baking soda. Maybe if you keep the container closed you can return it to wherever the new guy bought it from.

>close jar
It isn't something you can close.

>take jar
Taken.

>x box
The box is about the size of an old desktop computer. It's made of cardboard and smells slightly of oregano. The box is closed shut to keep the spices inside fresh.

>open jar
You shouldn't open the baking soda. Maybe if you keep the container closed you can return it to wherever the new guy bought it from.

>open box
That's already open.

>close box
You close the large box of spices.

>open fridge
You open the fridge.

>x fridge
Fridgey

* * *

>ask about dogs
You can't see any such thing.

>n
Store
A middle-aged man runs the store just north of the Kitchen. Since there are fewer customers today, the only things in the room besides you and the man is a table where the man has placed what he is selling and a little oven in the back.

>ask about dogs
You can't see any such thing.

>ask man about dogs
He doesn't care about that. The only thing he wants to talk about is his daughter. It's kind of weird, really.

There is no reply.

>ask man about daughter
He doesn't care about that. The only thing he wants to talk about is his daughter. It's kind of weird, really.

There is no reply.