Mamma mia! The world's most famous pizza chef, Pesto di Beppo, is coming to your restaurant in an hour and you still haven't made the pizza you promised him. You stand in the kitchen wondering what to do. North of the kitchen is a store filled with all kinds of gourmet foods and fancy supplies. West of the kitchen is your bedroom where you sleep every night after the restaurant closes. To your east is the dining room where you take special guests to enjoy your latest creations. Behind you is the restaurant, which is closed for the weekend.

Pizza Maker
An Interactive Fiction by Brennan
Release 1 / Serial number 141001 / Inform 7 build 6L38 (I6/v6.33 lib 6/12N) SD

Kitchen
Despite being one of the best pizza makers in the country, your kitchen is quite humble. You see a countertop dusted with flour, a box filled with spices, and your fridge.

>open box
Oh no! You completely forgot that yesterday was National Pizza Day! No wonder the kitchen is so empty! Now, the only jar left in the box is filled with baking soda. What kind of pizza can you make with just baking soda!?

* * *

I beg your pardon?

* * *

>n
Store
Store description.

>se
Dining Room
Dining room description.

>w
Kitchen
Despite being one of the best pizza makers in the country, your kitchen is quite humble. You see a countertop dusted with flour, a box filled with spices, and your fridge.

>e
Kitchen
Despite being one of the best pizza makers in the country, your kitchen is quite humble. You see a countertop dusted with flour, a box filled with spices, and your fridge.

* * *

>w
Kitchen
Despite being one of the best pizza makers in the country, your kitchen is quite humble. You see a countertop dusted with flour, a box filled with spices, and your fridge.

>w
Bedroom
Bedroom description.

>e
Kitchen
Despite being one of the best pizza makers in the country, your kitchen is quite humble. You see a countertop dusted with flour, a box filled with spices, and your fridge.

>n
Store
Store description.

>sw
Bedroom
Bedroom description.

* * *

>x player
You can't see any such thing.

>x self
You're the great-grandson of Raffaele Esposito, the man who many say created pizza.

>x the player
You can't see any such thing.

>describe self
You're the great-grandson of Raffaele Esposito, the man who many say created pizza.

* * *

>x countertop
The countertop is made of shiny black marble. A large box of spices is placed on the countertop.

>look
Kitchen
Despite being one of the best pizza makers in the country, your kitchen is quite humble. You see a countertop dusted with flour, a box filled with spices, and your fridge.

>x box of spices
Spices descripition.

>x countertop
The countertop is made of shiny black marble covered in flour. A large box of spices is placed on the countertop.

>x box of spices
Spices descripition.

* * *

>x box
The box is about the size of a mini fridge. It's made of cardboard and smells slightly of oregano. The box is closed shut to keep the spices inside fresh.

>open box
Inside the box are five clear jars each filled with a gourmet spice. The jars are arranged in alphabetical order: Basil, Cornmeal, Garlic, Oregano, and Salt.

>take basil
You can't see any such thing.

>take box
You'd better leave the actual box in the kitchen... Pesto di Beppo will be here soon!

>x countertop
The countertop is made of shiny black marble covered in flour. A large box of spices is placed on the countertop.